1111111111111111111111111111111111111111111
1000000000000000000000E00000000000000000001
1001000010011111001000000100000011111100001
100100001001000000100C000100000010000100001
1001000010010000001000000100000010000100001
1001111110011110001000000100000010000100001
1001000C10010000001000000100000010000100001
100100001001000000100000010000E010000100001
1001000010011111001111100111110011111100001
10000000000C00000000000000P0000000000C00001
100000000000000000C000000000000000000000001
1001111100100010011111001111100011111000001
100001000010001001000C001000010010000C00001
100001000C100010010000001000010010000000001
1000010000111110011110001111100011110000001
1000010000100C10010000001001000010000000001
1000010000100010010000001000100010000000001
1000010000100010011111001000010011111000001
100000E000000000E00000000000000000C00000001
1111111111111111111111111111111111111111111