1111111111111111111
1000001000000000001
10001E0001001000001
1000101001C01000001
10P0101001001100001
1000000000000100001
1111111111111111111