11111111111111111111111
10000010000000000000001
10001000000010010000001
10001010010000C01000001
10P01010010011000000001
10000000000000000100001
11111111111111111111111